     #         # #     #     
#### ##### ##### # ### # ####
       #             # # #   
## ####### ######### ### # ##
 # #   # # # #           #   
 # ### # ### # # # # ### # ##
 #     # #     # # # # #     
 ### # # ##### # # ### # # # 
   # #       # # # #     # # 
 # ####### ### # ##### # ### 
 #             #   #   #   # 
###### # ##### ### ### # ### 
   #   #   #     #   # #   # 
 # # # ####### # # # ##### ##
 #   #   #     # # #   # #   
 ########### ########### ### 
   # #     # #         #   # 
 # # # ### # # # ##### # # ##
 #   # #       # #       #   
